1111111111111111111111111111
1P00000000000000000000000001
1000000001110000001111110001
1000000111100000111000111001
1000011101110000000111000001
1001110011100000111000000001
1111111111100011100000000011
1000011100001110000000000001
1000111000111111111C00000011
1000000000000000000000000E11
1111111111111111111111111111
