1111101
1000001
1CPE001
1111111
