1111111
10000E1
100P001
1111111
