1111111111
1P00000001
1011100001
100C100001
1011100101
1000001E01
1111111111
