111111111111111111111111111111111111111111111111111111111111
1P00000000000000000C000000000000000000000C000000000000000001
100001111110000001111110000001111110000011111100000111110001
1C0001000000000001000000000C01000000000100000000001000000001
100001000000C00001000000000001000000000100000000001000000001
100001000001111111000011000001111111000011111111000111110001
100000000001000000000011000001000000000010000000000010000001
100000C000010000001C000000000100000000010000001C001000000001
100001111110000001111111000001111111000011111110001111110001
10000100000000C000000001000001000000000010000000001000000001
1C000100000000000100000001C001000000000010000000001C00000001
100001111111111110000001000001111111111110000001111111110001
100000000000000000000001000001000000000000000001000000000001
1000C0000000000000000C00000001000C000000000000010000C0000001
100001111110000001111111111111111111100000111111110000111001
10000100000000C000000001000001000001000001000001000001000001
100001000000000000000001000001000001000001000001000001000001
100001111111111111100001111111000001111111000001111111000001
100000000000000000100000000000000000000000000000000001000001
100000C000000000001C00000000000000000000000C000000001C000001
100001111111111110000001111111111111111111100000001111110001
100001000000000000000001000000000000000001000000000010000001
1000010000000C0001000000010000000000000000010000000000100C01
100001111110001111100000011111110000111111110000111111111001
100000000010000000100000000000010000000000010000000000000001
100000000010000001C0000000000001C000000000010000001C00000001
100000111111000001111111111111111111111111110000001111111001
100000100000000000000000000000000000000000010000000000000001
10000010000000000000000000C0000000000000000100000000000000E1
111111111111111111111111111111111111111111111111111111111111
