1111111111
1PP0000001
1000000001
1000000001
1000000001
1000000E01
1111111111
